危ない　- dangerous

赤い - red

明るい - light / cheerful

甘い - sweet

青い - blue

新しい - new / latest

暖かい - warm

厚い - thick

暑い - hot (for temperature / climate)

熱い - hot (for drinks / food)

小さい - small

近い - near

古い - old (for inanimate object)

太い(ふとい)　- fat thick

早い - early 

速い - fast /  quick

低い - low

欲しい - want

細い(ほそい)　- slender

忙しい - busy

痛い - pain

辛い - spicy

軽い(かるい) -　light 

可愛い - cute

黄色い - yellow

汚い - dirty

暗い(くらい) - dark (for atmosphere)
 
黒い - black

丸い - circular

不味い　- unpleasant 

短い（みじかい）- short

難しい　- difficult

長い　- long(distance); long(time)

温い（ぬるい） - luke warm

美味しい - delicious

重い - heavy

面白い - interesting

多い - a lot

大きい - big / important

遅い（おそい） - slow

寒い　- cold

狭い（せまい） - narrow

白い - white

少ない - little / few / scarce

涼しい - cooling / refreshing

高い - high / tall / expensive

楽しい - enjoyable / fun

遠い - far

詰まらない - boring

冷たい - cold (to the touch)

強い - powerful

煩い（うるさい） - noisy, annoying

薄い（うすい） - thin;weak

若い（わかい） - young

悪い - bad; poor; undesirable

優しい - kind 　

安い（やすい） - cheap;inexpensive

良い - good
　
弱い - weak
